1000000000-
1000000000-
1000000000-
1000000000-
1000000000-
1111111110-
0000000010-
0000000010-
0000000010-
0000000010